......!...
##....##..
12..#.##.
34........
##...###12
!...!...!.
##12.###34
.!..!.....
##...###..
.........@
