..........
##...###..
....#.##.
..........
##...###..
..........
##...###..
..........
##...###..
.........@
