!...T...!
T...##...
....#..#.
34........
.....T....
..T...@...
##12...#..
..........
34...12D.4
.!........
