..........##...###..##...###..
##...###..##...###..##...###..
....#.##.##...###..##...###..
..........##...###..##...###..
##...###..##...###..##...###..
....................##...###..
##...###............##...###..
..............................
##...###..##...###............
.........##...###..##...###...
..........##...###..##...###..
##...###..##...###..##...###..
....#.##.##...###..##...###..
..........##...###..##...###..
##...###..##...###..##...###..
....................##...###..
##...###............##...###..
..............................
##...###..##...###............
.........##...###..##...###...
..........##...###..##...###..
##...###..##........##...###..
....#.##.##...###..##...###..
..........##...###..##...###..
##...###..##...###..##...###..
....................##...###..
##...###............##...###..
..............................
##...###..##...###............
.........##...###..##...###...
..........##...###..##...###..
##...###..##...###..##...###..
....#.##.##...###..##...###..
..........##...###..##...###..
##...###..##...###..##...###..
....................##...###..
##...###............##...###..
..............................
##...###..##...###............
.........##...###..##...###..@