.!..!.....##....##..
.2..!...!!....#.#..
....#.##.##...###..#
....#.!...#...###..
..#...###..##...###.
.!..#....#...#......
.#...###..!...12....
...!....@.....34....
.....#.#..##...###..
.#..#....##...###..#
.12.....##...###....
#34..#.#..##..!.##.2
..!.#.##.##...###..4
..!..#....##...###.1
.12!..##..##...##..3
...#...#............

