D........##.!..TT..
.2..!.T.!!..4.T.#..
....T.TT.TT.......#
....#.!...#...TT#..
..#...###..##......
.!..#....#...#......
.#...###......12....
...!....@.....34....
.....#.#..##...###..
.#..#....##....##..#
.12.....##...###!!..
#34..#.#..##..!.##.2
..!.#.##.#T...###..4
..!..#....##...###.1
.12!..##..##...##..3
...#...#..........D.