TTTMTTTT..TTT.TT
TT.....TT..T.!!T
T....T...12.....
...T...T.34..TTT
......12.@....MT
....TTT.....T...
1..T.......TT...
.....T.......12.
..T....TTTTT.34.
.T...TTTTT...TTT
TT..TT...TTT...T
T..TTTT..TTTTT..
..T.M..T..T.T..T
T......T.M...T...
TTTTT.......TT.T.
.TT.TT..T......T