..T##M.......T###12
...#T...TTTTTT.34..
..12......!..T..T@.
....12#T...!...TTTT.
M...34..##...!......
...#..!......TT..2.
..12..##.....34...!.
..34.............T#.
TTT...M....12...T...
..#..!..T..34..3..#.
!..............4...T
...!......T..#..T..!
..M...####...12..!!.
.....####....34...!.
......##...M...12..T
TTTTT..#..!.......#.
..TTT..12...!.......
T...T....!....M...2.
...!....#3...!...TTT
!!.T...#.4..!.......